0111111111111111111111112
3444444444444444444444445
3444444444444444444444445
3444444444444444444444445
3444444444444444444444445
3444440244444444402444445
3444446844444444468444445
3444444444444444444444445
3444444444444444444444445
3444444444444444444444445
3444444444444444444444445
3444444444444444444444445
3444440244444444402444445
3444446844444444468444445
3444444444444444444444445
3444444444444444444444445
3444444444444444444444445
3444444444444444444444445
6777777777777777777777778