11111111111111111111111111111111111111111111111111
10000000000000000000000000000000000000000000000001
10400000000000000000000000000000000000000111000001
10000000000000000000000000000000000000000101000001
10000000000000000000000000000000000000000111000001
10000000000000000000000000000000000000000000000001
10000000000000000000000000000000000000000000000001
11100001111000010000000050000000000000000000000001
11122221111222211000000000000000000000000000000001
11111111111111111111111111111111111111111111110001
10000000000000000000000000000000000000000000010001
10000000000000000000000000000000000000000000010001
10000000000000000000000000000000000000000000010001
10000000500000000000000000000000000000000000000001
10000000000000000000000000000000000000000000000001
10000111111111100000000000000000000000000000000001
10000111111111111000011111100111110011010101111111
10000100000000000000000000000000000000000000000001
10000122222222222222222222222222222222222222222221
10000111111111111111111111111111111111111111111111
10000100000000000000000000000000000000000000000001
10000100000000000000000000000000000000000000000001
10000100000000000000000000000000000000000000000001
10000100000000000000000000000000000000000010000001
10000100000000000000000000000000000001110010000001
10000100000000000000000000000000000000000010000001
10000100000000000000000000000000011000000010000001
10000100000000000000000000000000000000000010000001
10000100000000000000000000000110000000000010000001
10000100000000000000000000000000000000000010000001
10000100000000000000000001100000000000000010000001
10000100000000000000000000000000000000000010000001
10000100000000000000011000000000000000000010000001
10000100000000000000000000000000000000000010000001
10000000000000000011000000000000000000000010000001
10000000500000000000000000000000000000000010003001
10000000000001110000000000000000000000000010003001
11111111111111222222222222222222222222222211111111